NO ./texture/ws_01.xpm
SO ./texture/ws_02.xpm
WE ./texture/ws_03.xpm
EA ./texture/ws_04.xpm

C 220,220,220
F 50,30,20

11111
10001
11011
10001
11011
10001
11011
10001
11011
10001
11011
10001
11011
10001
11011
10001
11011
10001
11011
10001
11011
10001
11011
10001
11011
10001
11011
10001
11011
10001
11011
10001
11011
10001
11011
10001
11011
10001
11011
10001
11011
10001
11N11
11111
