WE ./texture/West.xpm
NO ./texture/North.xpm
C 220,220,220
SO ./texture/South.xpm
EA ./texture/East.xpm
F 50,30,20
        111111111111111111111
        10000000011000000010111111111111
        10110000011100000000000000000000111111
        10010000000000000000000011111111
111111110110000011100000000001111111
100000000011000001110111111111111
11110111111111011100000010001
11110111111111011101010010001 111
1100001101010111000000100011  101
10000S0000000000110000010001  111
1000000000000011010100100001
110000011101010111110111100011
11110111 1110101 101111010101
111111111111111111111111 1 1
1
