NO ./texture/North.xpm
SO ./texture/South.xpm
WE ./texture/West.xpm
EA ./texture/East.xpm

F 50,30,0
C 220,220,220

111111
100101
101001
1100N1
111111
