WE ./texture/West.xpm
NO ./texture/North.xpm
SO ./texture/South.xpm
EA ./texture/East.xpm

F 50,30,20

C 220,220,220



        1111111111111111111111111
        1000000001100000000000001111111111
        10110000011100000000000000000000111111
        10010000000000000000000011111111
1111111110110000011100000000001111111
100000000011000000110110111111111
11110111111110000000000010001
11110111111111000000000S10001 111
11000000110101000000000010001 101
1000000000000000000000000001  111
1000000000000011010100100001
110000011101010111110111100111
11110111 1110101 101111010001
11111111111111111111111111111
