WE ./texture/West.xpm
NO ./texture/North.xpm

C 220,220,220
SO ./texture/South.xpm
EA ./texture/East.xpm
F 50,30,20

C 220,220,220



        1111111111111111111111111
        1000000001100000000000001111111111
        10110000011100000000000000000000111111
        10010000000000000000000011111111
1111111110110000011100000000001111111
100000000011000001110111111111111
11110111111111011100000010001
11110111111111011101010010001 111
11000000110101011100000010001 101
1000000000000000110000010001  111
10000000000000110101001000S1
110000011101010111110111100111
11110111 1110101 101111010001
11111111111111111111111111111